##################
#           20   #
#                #
#                #
#                #
#                #
#         X      #
#                #
#      10        #
##################
