##################
#                #
#                #
#            10  #
#                #
#                #
#         X      #
# 20             #
#                #
##################
